7 7 1
@@@@@@@
@@C...@
@...@@@
@.....@
@@@@@.@
@.....@
@@@@K@@