6 6 2
@@@@@@
@....|
@....@
@....@
@K...@
@@@@@@
@@@@@@
@C.@K@
@..@.@
@....@
@....@
@@@@@@