10 10 2
@@@@......
...@.@.@..
.@.@.@.@..
.@.@.@.@..
.@.@.@@@@.
.@.@.@..@.
.@.@.@..@.
.@......@.
.@@@@@@@@.
..|@K.....
..@@.@@@C.
..K@...@..
...@.@.@..
.@@@.@.@..
.@...@.@..
.@.@.@.@@.
.@.@.@....
...@@@.@..
...@...@..
...@...@..