6 6 3
@@@@@@
@K...@
@....@
@....|
@..@@@
@@@@@@

@|@@@@
@....@
@@@@.@
@....@
@.@@@@
@K@@@@

@@@@@@
@....@
@.@@.@
@....@
@@..@@
@@K@@@